XXXXXXXXXXXXXXXXXXXX
XXXXXXXXXXXXXXXXXXXX
X   X X X   X   X   
X XXX X X X X  XX XX
X XXX   X   XX  X  X
X   X X X X X   X   
XXXXXXXXXXXXXXXXXXXX
XXXXXXXXXXXXXXXXXXXX
XXXXXXXXXXXXXXXXXXXX
XXXXXXXXXXXXXXXXXXXX
XXXXXXXXXXXXXXXXXXXX
XXXXXXXXXXXXXXXXXXXX
XXXXXXXXXXXXXXXXXXXX
XXXX            XXXX
XXXX    XXXXX   XXXX
XXXX            XXXX
XXXX    XXXX    XXXX
XX        XX      XX
XX  XXXXXXXXXXXX  XX
XXXXXXXXXXXXXXXXXXXX